8 . x o
........
..x.....
....x...
........
....x...
..x.....
........
........
